###### NE PAS MODIFIER LA MIS EN PAGE ######
level=1
nb_largeur=10
nb_hauteur=10
Time_Limit(s)=60
########## CODE GÉNÉRANT LA CARTE ########
102#301#100#100#100#100#100#100#100#100
00B#00B#00B#00B#002#100#00B#007#003#100
100#009#100#00B#100#100#009#110#111#100
100#005#00A#00B#100#007#00D#102#401#100
100#100#009#00B#100#100#009#101#100#003
004#102#009#101#401#100#00C#007#101#100
002#100#009#100#005#007#00D#100#500#100
100#100#009#101#100#101#002#100#401#100
00B#007#006#101#004#101#101#100#009#100
002#201#102#100#002#100#001#007#006#100