###### NE PAS MODIFIER LA MIS EN PAGE ######
level=1
nb_largeur=10
nb_hauteur=10
Time_Limit(s)=100
########## CODE GÉNÉRANT LA CARTE ########
102#301#100#100#004#100#100#100#100#100
100#00B#003#100#002#100#00B#007#003#100
100#009#100#401#100#100#009#110#111#100
100#005#00A#100#001#007#00D#113#112#100
100#100#009#100#100#100#009#500#00B#003
004#102#009#100#401#100#00C#007#006#100
002#100#009#100#005#007#00D#100#100#100
100#100#009#101#100#101#002#100#004#100
00B#007#006#101#004#101#101#100#009#100
002#100#100#100#002#100#001#007#006#200